1111111111111
1E000000000C1
1110101C10101
10101C1C10101
1P000000000C1
1111111111111