1111111111111
1000010001001
1E00C00C00001
1P00001000001
1111111111111