1111111111111
1000000000001
1000C00P00001
1000C00E00001
1000000000C01
1111111111111