111111
1P01E1
101101
101001
101101
10C001
101101
100001
101101
1C00C1
111111
